```plaintext
ABS -> 'ABS' '(' NUMERIC_VALUE ')'
ACOS -> 'ACOS' '(' NUMERIC_VALUE ')'
ASIN -> 'ASIN' '(' NUMERIC_VALUE ')'
ATAN -> 'ATAN' '(' NUMERIC_VALUE ')'
ATAN2 -> 'ATAN2' '(' NUMERIC_VALUE ',' NUMERIC_VALUE ')'
CEIL -> 'CEIL' '(' NUMERIC_VALUE ')'
CEILING -> 'CEILING' '(' NUMERIC_VALUE ')'
COS -> 'COS' '(' NUMERIC_VALUE ')'
COSH -> 'COSH' '(' NUMERIC_VALUE ')'
COT -> 'COT' '(' NUMERIC_VALUE ')'
DEGREES -> 'DEGREES' '(' NUMERIC_VALUE ')'
EXP -> 'EXP' '(' NUMERIC_VALUE ')'
FLOOR -> 'FLOOR' '(' NUMERIC_VALUE ')'
GREATEST -> 'GREATEST' '(' NUMERIC_VALUE ',' NUMERIC_VALUE ')'
GREAT -> 'GREAT' '(' NUMERIC_VALUE ',' NUMERIC_VALUE ')'
LEAST -> 'LEAST' '(' NUMERIC_VALUE ',' NUMERIC_VALUE ')'
LN -> 'LN' '(' NUMERIC_VALUE ')'
LOG -> 'LOG' '(' NUMERIC_VALUE ',' NUMERIC_VALUE ')' | 'LOG' '(' NUMERIC_VALUE ')'
LOG10 -> 'LOG10' '(' NUMERIC_VALUE ')'
MOD -> 'MOD' '(' NUMERIC_VALUE ',' NUMERIC_VALUE ')'
PI -> 'PI' '(' ')'
POWER -> 'POWER' '(' NUMERIC_VALUE ',' NUMERIC_VALUE ')'
POWER2 -> 'POWER2' '(' NUMERIC_VALUE ',' NUMERIC_VALUE ')'
RADIANS -> 'RADIANS' '(' NUMERIC_VALUE ')'
RAND -> 'RAND' '(' NUMERIC_VALUE ')' | 'RAND' '(' ')'
ROUND -> 'ROUND' '(' NUMERIC_VALUE ',' NUMERIC_VALUE ')' | 'ROUND' '(' NUMERIC_VALUE ')'
SIGN -> 'SIGN' '(' NUMERIC_VALUE ')'
SIN -> 'SIN' '(' NUMERIC_VALUE ')'
SINH -> 'SINH' '(' NUMERIC_VALUE ')'
SQRT -> 'SQRT' '(' NUMERIC_VALUE ')'
TAN -> 'TAN' '(' NUMERIC_VALUE ')'
TANH -> 'TANH' '(' NUMERIC_VALUE ')'
TO_NUMBER -> 'TO_NUMBER' '(' CHAR_VALUE ',' FMT_VALUE ')' | 'TO_NUMBER' '(' CHAR_VALUE ')'
TRUNC -> 'TRUNC' '(' NUMERIC_VALUE ',' NUMERIC_VALUE ')' | 'TRUNC' '(' NUMERIC_VALUE ')'
TRUNCATE -> 'TRUNCATE' '(' NUMERIC_VALUE ',' NUMERIC_VALUE ')' | 'TRUNCATE' '(' NUMERIC_VALUE ')'
TO_CHAR -> 'TO_CHAR' '(' NUMERIC_VALUE ',' FMT_VALUE ',' NLS_VALUE ')' | 'TO_CHAR' '(' NUMERIC_VALUE ',' FMT_VALUE ')' | 'TO_CHAR' '(' NUMERIC_VALUE ')'
BITAND -> 'BITAND' '(' NUMERIC_VALUE ',' NUMERIC_VALUE ')'
```